Date,Traffic_Mawa,Traffic_Jajira,Cash_Mawa,Cash_Jajira,Total_Traffic,Total_Cash
26/06/2022,26589,24727,10887150,10044400,51316,20931550
27/06/2022,10597,12183,10510900,11416050,22780,21926950
28/06/2022,7217,7276,9666800,9791300,14493,19458100
29/06/2022,6989,7116,9533150,9759650,14105,19292800
30/06/2022,7515,6895,10141450,9651000,14410,19792450
07/01/2022,13801,12597,16542100,15111100,26398,31653200
07/02/2022,8377,9627,10896450,12375200,18004,23271650
07/03/2022,6605,6786,9451200,9745150,13391,19196350
07/04/2022,6614,7010,9463050,10501250,13624,19964300
07/05/2022,7631,7762,10922850,11753850,15393,22676700
07/06/2022,8877,7832,12466650,11737100,16709,24203750
07/07/2022,13395,9308,17767750,13883900,22703,31651650
07/08/2022,19667,12056,24750250,17189400,31723,41939650
07/09/2022,11513,8283,15724550,11663750,19796,27388300
07/10/2022,6747,5207,8137750,6473100,11954,14610850
07/11/2022,17735,14705,19396550,16658850,32440,36055400
07/12/2022,14969,16442,16925750,18438700,31411,35364450
13/07/2022,11713,14416,13919600,16508850,26129,30428450
14/07/2022,10748,13031,13449400,15698650,23779,29148050
15/07/2022,13117,16640,16705900,19875150,29757,36581050
16/07/2022,11414,16081,15754750,20056050,27495,35810800
17/07/2022,8571,10005,12468700,13811400,18576,26280100
18/07/2022,7588,8287,11156600,11900150,15875,23056750
19/07/2022,7162,7444,10689800,10814400,14606,21504200
20/07/2022,6672,6835,10032450,10213650,13507,20246100
21/07/2022,7291,6762,10566200,10060250,14053,20626450
22/07/2022,11512,11233,15259650,14883950,22745,30134600
23/07/2022,7500,8457,10481750,11441650,15957,21923400
24/07/2022,5863,5946,8849000,8696100,11809,17545100
25/07/2022,6129,5988,9235600,9083600,12117,18319200
26/07/2022,6140,5807,9398000,8877800,11947,18275800
27/07/2022,6222,6133,9414950,9227900,12355,18641850
28/07/2022,6840,6507,9844000,9942350,13347,19786350
29/07/2022,11076,10582,14743300,14370400,21658,29113700
30/07/2022,6946,8226,9778250,11100950,15172,20879200
31/07/2022,6177,6413,9228050,9513950,12590,18742000
08/01/2022,6071,6259,9195100,9670800,12330,18865900
08/02/2022,6100,5955,9375900,9112600,12055,18488500
08/03/2022,6139,6151,9534000,9303100,12290,18837100
08/04/2022,6670,6209,9878700,9683600,12879,19562300
08/05/2022,11019,10128,14763550,13844800,21147,28608350
08/06/2022,6620,7795,9495350,10635650,14415,20131000
08/07/2022,5723,5824,9077250,8856500,11547,17933750
08/08/2022,5988,5710,9432950,9014850,11698,18447800
08/09/2022,7708,7930,11129750,11591200,15638,22720950
08/10/2022,5421,5548,8484550,8738350,10969,17222900
08/11/2022,6898,6100,10603900,9539650,12998,20143550
08/12/2022,9561,8959,13201850,12661500,18520,25863350
13/08/2022,6248,7070,9459250,10187800,13318,19547050
14/08/2022,5936,5478,9308100,8408750,11414,17716850
15/08/2022,7484,7970,10855600,11404900,15454,22260500
16/08/2022,5123,5640,8116300,8881550,10763,16997850
17/08/2022,6135,6052,9648050,9803000,12187,19451050
18/08/2022,9535,6417,12821050,9123500,15952,21944550
19/08/2022,8648,9042,12166950,12390250,17690,24490250
20/08/2022,6249,8229,9293700,11362300,14478,20656000
21/08/2022,5494,5667,8712700,8843350,11161,17556050
22/08/2022,5476,5789,8818900,9386600,11265,18205500
23/08/2022,5553,5696,8918700,9209300,11249,18128000
24/08/2022,5679,5864,9118800,9487950,11543,18606750
25/08/2022,6273,5981,9864100,9732650,12254,19596750
26/08/2022,8877,8532,12492750,12470050,17409,24962800
27/08/2022,6,7406,9353450,10674050,13743,20027500
28/08/2022,5408,5663,8503150,8870950,11071,17374100
29/08/2022,5643,5834,9063650,9181900,11477,18245550
30/08/2022,5663,5964,8963000,9595250,11627,18558250
31/08/2022,5711,6054,8948100,9635500,11765,18583600
09/01/2022,6414,6154,9588950,9781100,12568,19370050
09/02/2022,8382,8264,11546450,11915850,16646,23462300
09/03/2022,6820,7385,9959150,10485100,14205,20444250
09/04/2022,5430,6840,8533000,10625950,12270,19158950
09/05/2022,5547,5865,8731650,9265500,11412,17997150
09/06/2022,5657,5448,8862600,8517250,11105,17379850
09/07/2022,5768,5936,8991750,9336950,11704,18328700
09/08/2022,6540,6230,10072700,9998050,12770,20070750
09/09/2022,8502,8093,11965600,11685550,16595,23651150
09/10/2022,6067,7155,8909150,10270100,13231,19179250
09/11/2022,5659,6016,8717350,9124450,11675,17841800
09/12/2022,5783,5708,9048550,8812250,11491,17860800
13/09/2022,5397,5334,8683850,8349000,10731,17032850
14/09/2022,5069,5419,8106450,8570750,10488,16677200
15/09/2022,6016,5677,9315850,8923250,11693,18239100
16/09/2022,8171,7919,11532050,11476500,16090,23008550
17/09/2022,5760,6886,8647350,10077950,12646,18725300
18/09/2022,5682,6008,8911750,9161950,11690,18073700
19/09/2022,5754,5908,9186450,9397150,11662,18583600
20/09/2022,5880,5927,9527950,9423850,11807,18951800
21/09/2022,6085,6150,9685200,9791300,12235,19476500
22/09/2022,6551,6252,10011900,9960100,12803,19972000
23/09/2022,8644,8326,12364800,12156300,16970,24521100
24/09/2022,6155,7143,9327350,10390450,13298,19717800
25/09/2022,5740,6170,9048550,9617100,11910,18665650
26/09/2022,5840,5890,9428000,9353250,11730,18781250
27/09/2022,5917,6053,9516900,9731000,11970,19247900
28/09/2022,6087,6283,9617350,9981950,12370,19599300
29/09/2022,6853,6428,10324850,10097350,13281,20422200
30/09/2022,9850,8746,13569150,12557100,18596,26126250
10/01/2022,6887,7653,10002700,11063300,14540,21066000
10/02/2022,6363,6587,9386900,9929850,12950,19316750
10/03/2022,6665,6418,10027850,9857250,13083,19885100
10/04/2022,7417,6843,10824650,10339000,14260,21163650
10/05/2022,8925,8175,12150800,11490400,17100,23641200
10/06/2022,7263,6892,10243800,10131700,14155,20375500
10/07/2022,9645,7731,12879400,10326700,17376,23206100
10/08/2022,7635,10585,10839650,14683750,18220,25523400
10/09/2022,7798,10519,11356300,14006850,18317,25363150
10/10/2022,5750,6961,9029650,10559900,12711,19589550
10/11/2022,6557,6507,10514950,10379250,13064,20894200
10/12/2022,6381,6356,10171450,10103750,12737,20275200
13/10/2022,6619,6544,10160850,10409050,13163,20569900
14/10/2022,8756,8204,12745800,12170800,16960,24916600
15/10/2022,6407,7339,9813500,10716400,13746,20529900
16/10/2022,5966,6302,9289850,9910300,12268,19200150
17/10/2022,6334,6591,10150100,10499650,12925,20649750
18/10/2022,6281,6816,9731200,10576650,13097,20307850
19/10/2022,6171,6503,9946950,10258100,12674,20205050
20/10/2022,6936,6539,10583300,10182100,13475,20765400
21/10/2022,8261,7887,11652200,11330450,16148,22982650
22/10/2022,5880,7226,8709300,11330450,13106,19041850
23/10/2022,5998,6471,9426150,10165150,12469,19591300
24/10/2022,4864,3945,7496550,5944550,8809,13441050
25/10/2022,4164,5168,6615600,8137900,9332,14753500
26/10/2022,5764,5968,9067600,9392300,11732,18459900
27/10/2022,6637,6424,10266900,10195550,13061,20462450
28/10/2022,8568,7652,12381000,11208150,16220,23589150
29/10/2022,6068,7692,9093050,11217850,13760,20310900
30/10/2022,5820,6326,9105700,9739900,12146,18845600
31/10/2022,6228,6295,9914650,9914550,12523,19829200
11/01/2022,6184,6430,9729450,10116450,12614,19845900
11/02/2022,6139,6317,9649900,10041200,12456,19691100
11/03/2022,7126,6560,10894100,10504200,13686,21398300
11/04/2022,8106,7729,11530900,11137900,15835,22668800
11/05/2022,5659,6765,8380700,9421000,12424,17801700
11/06/2022,6105,6329,9654450,9680300,12434,19334750
11/07/2022,6257,6589,9726000,10405050,12846,20131050
11/08/2022,6265,6365,9923150,10093900,12630,20017050
11/09/2022,6312,6471,9923350,10285050,12783,20208400
11/10/2022,7213,6786,11234350,10703900,13999,21938250
11/11/2022,8328,7895,11861000,11529200,16223,23390200
11/12/2022,5761,6623,8556100,9436000,12384,17992100
13/11/2022,6057,6904,9404650,10529650,12961,19934300
14/11/2022,6329,6355,10142450,10072200,12684,20214650
15/11/2022,6534,6518,10399050,10344350,13052,20743400
16/11/2022,6403,6438,10148400,10301000,12841,20449400
17/11/2022,7121,6650,10950750,10714500,13771,21665250
18/11/2022,8839,8662,12779250,12901900,17501,25681150
19/11/2022,6288,7595,9562000,10959750,13883,20521750
20/11/2022,6220,6442,9798450,10059300,12662,19857750
21/11/2022,6126,6530,9864500,10541200,12656,20405700
22/11/2022,6186,6193,9818300,9959650,12379,19777950
23/11/2022,6458,6340,10120250,10012050,12798,20132300
24/11/2022,6784,6367,10251150,9916250,13151,20167400
25/11/2022,8290,8015,11972300,11788650,16305,23760950
26/11/2022,6122,7200,9300500,10426850,13322,19727350
27/11/2022,5981,6372,9496700,9926500,12353,19423200
28/11/2022,6295,6788,9923250,10942750,13083,20866000
29/11/2022,6172,6516,9594800,10256300,12688,19851100
30/11/2022,6246,6233,9740700,9902500,12479,19643200
12/01/2022,7112,6779,10805550,10703550,13891,21509100
12/02/2022,8082,7851,11672550,11583450,15933,23256000
12/03/2022,5983,6993,8922650,10127300,12976,19049950
12/04/2022,5680,6060,8792400,9394050,11740,18186450
12/05/2022,5859,6194,9102800,9864950,12053,18967750
12/06/2022,6169,6469,9706350,10247250,12638,19953600
12/07/2022,6169,6177,9530500,9773900,12346,19304400
12/08/2022,6339,5457,9431650,8425300,11796,17856950
12/09/2022,5607,4578,8264850,7028300,10185,15293150
12/10/2022,2595,3076,3736550,4380600,5671,8117150
12/11/2022,4898,6391,7322300,9833100,11289,17155400
12/12/2022,6654,6533,10328900,10265400,13187,20594300
13/12/2022,6573,6626,10165950,10381050,13199,20547000
14/12/2022,7026,6845,10591750,10619450,13871,21211200
15/12/2022,8310,7195,11877600,11170200,15505,23047800
16/12/2022,10625,9161,14601850,12995100,19786,27596950
17/12/2022,6979,8690,9895600,12102500,15669,21998100
18/12/2022,6715,7265,10168800,10705550,13980,20874350
19/12/2022,7036,7232,10415100,10851650,14268,21266750
20/12/2022,7480,7215,11173150,10801050,14695,21974200
21/12/2022,7856,7595,11600950,11513000,15451,23113950
22/12/2022,9981,7956,14071750,11953250,17937,26025000
23/12/2022,12718,10107,16933450,14267400,22825,31200850
24/12/2022,8558,8882,11908650,12365950,17440,24274600
25/12/2022,9119,10645,12764850,13664800,19764,26429650
26/12/2022,7346,9609,10852450,13579150,16955,24431600
27/12/2022,7818,8020,11725100,11886900,15838,23612000
28/12/2022,7888,7725,11764800,11528550,15613,23293350
29/12/2022,8580,7807,12839250,11647250,16387,24486500
30/12/2022,10089,9401,14621200,13382450,19490,28003650
31/12/2022,7619,9386,11245050,13041350,17005,24286400
01/01/2023,7107,7629,10633250,10987900,14736,21621150
01/02/2023,6810,7294,10357600,11137250,14104,21494850
01/03/2023,7569,6847,11758900,10515650,14416,22274550
01/04/2023,6836,7791,10285800,12075200,14627,22361000
01/05/2023,7775,6991,11179500,10533750,14766,21713250
01/06/2023,8957,8646,12576800,12383700,17603,24960500
01/07/2023,6552,8198,9425800,11338200,14750,20764000
01/08/2023,6458,7026,9777650,10495500,13484,20273150
01/09/2023,6680,6699,10307750,10424250,13379,20732000
01/10/2023,6738,6671,10464550,10213800,13409,20678350
01/11/2023,6768,7292,10248150,11404200,14060,21652350
01/12/2023,7495,7085,10829500,10863800,14580,21693300
13/01/2023,9046,8531,12919100,12408000,17577,25327100
14/01/2023,6938,8007,10115400,11232550,14945,21347950
15/01/2023,6970,7267,10716900,10869200,14237,21586100
16/01/2023,6787,7051,10483700,10823400,13838,21307100
17/01/2023,6837,6630,10432750,10187500,13467,20620250
18/01/2023,6916,7112,10521350,11029500,14028,21550850
19/01/2023,7828,7255,11485150,11351450,15083,22836600
20/01/2023,9504,8587,13596050,12470400,18091,26066450
21/01/2023,7006,8207,10223200,11669100,15213,21892300
22/01/2023,6663,7152,10223800,10666750,13815,20890550
23/01/2023,6967,6954,10722650,10673300,13921,21395950
24/01/2023,6764,6757,10363400,10490250,13521,20853650
25/01/2023,7231,6826,10722950,10517100,14057,21240050
26/01/2023,8278,7465,11923400,11562300,15743,23485700
27/01/2023,9581,8844,13453550,12490950,18425,25944500
28/01/2023,7116,8681,10387300,12043700,15797,22431000
29/01/2023,6533,7375,9941400,10942900,13908,20884300
30/01/2023,6768,7108,10510550,10866850,13876,21377400
31/01/2023,6881,6980,10603950,10707300,13861,21311250
02/01/2023,7132,6942,10857200,10739050,14074,21596250
02/02/2023,8188,7067,12072900,11014400,15255,23087300
02/03/2023,9516,8970,13341600,12878100,18486,26219700
02/04/2023,7001,8288,10398750,11708350,15289,22107100
02/05/2023,6685,7594,10213400,11432000,14279,21645400
02/06/2023,6690,6837,10325800,10654550,13527,20980350
02/07/2023,6690,6618,10439500,10367300,13308,20806800
02/08/2023,6668,6832,10236300,10778900,13500,21015200
02/09/2023,7808,7160,11599900,11203350,14968,22803250
02/10/2023,9370,8781,13233500,12788850,18151,26022350
02/11/2023,6990,8419,10347500,11982400,15409,22329900
02/12/2023,6787,6974,10548150,10485100,13761,21033250
13/02/2023,6855,7138,10703400,11306600,13993,22010000
14/02/2023,6898,6890,10913300,10813850,13788,21727150
15/02/2023,6936,6991,10612200,11137800,13927,21750000
16/02/2023,8528,7470,12574250,11814300,15998,24388550
17/02/2023,10091,9077,14342400,13388300,19168,27730700
18/02/2023,7882,8753,11797000,12316750,16635,24113750
19/02/2023,7058,7807,10856350,11689400,14865,22545750
20/02/2023,8190,7282,12431000,11457850,15472,23888850
21/02/2023,8631,10456,12565200,15525050,19087,28090250
22/02/2023,6521,6847,9847550,10526200,13368,20373750
23/02/2023,8010,7242,11795900,11306500,15252,23102400
24/02/2023,9764,9062,13972150,13115500,18826,27087650
25/02/2023,6951,8405,10415350,11594100,15356,22009450
26/02/2023,6807,7702,10588150,11603550,14509,22191700
27/02/2023,6991,6984,10880800,10862200,13975,21743000
28/02/2023,7280,7182,11134000,11265800,14462,22399800
03/01/2023,7186,7129,11139900,11136650,14315,22276550
03/02/2023,7796,7305,11732100,11631700,15101,23363800
03/03/2023,9269,8778,13165950,12912800,18047,26078750
03/04/2023,6866,8130,10315500,11669400,14996,21984900
03/05/2023,6654,7323,10291550,11337100,13977,21628650
03/06/2023,7101,7304,10989550,11655750,14405,22645300
03/07/2023,7306,7094,11352400,11239850,14400,22592250
03/08/2023,7754,7389,11393250,11236150,15143,22629400
03/09/2023,6879,6857,9982750,10787150,13736,20769900
03/10/2023,9318,9198,13366800,13483950,18516,26850750
03/11/2023,7344,8942,11034800,12815300,16286,23850100
03/12/2023,7030,7373,10884000,11309350,14403,22193350
13/03/2023,7237,7074,11308700,11103700,14311,22412400
14/03/2023,7152,7256,11073850,11596400,14408,22670250
15/03/2023,7177,7434,10993450,11778750,14611,22772200
16/03/2023,8075,7389,11815500,11587250,15464,23402750
17/03/2023,9118,8863,12923300,12958200,17981,25881500
18/03/2023,7375,8816,11048900,12700700,16191,23749600
19/03/2023,6930,7386,10694850,11160300,14316,21855150
20/03/2023,7273,7356,11156350,11402650,14629,22559000
21/03/2023,7279,7609,11183100,11848200,14888,23031300
22/03/2023,6952,7405,10772100,11587900,14357,22360000
23/03/2023,7267,7433,11309500,11833200,14700,23142700
24/03/2023,6647,5874,10446100,9568600,12521,20014700
25/03/2023,5271,5341,8133650,8348000,10612,16481650
26/03/2023,5669,6408,8929100,9738750,12077,18667850
27/03/2023,5051,5659,8131850,8772450,10710,16904300
28/03/2023,5738,5740,9294650,9205100,11478,18499750
29/03/2023,5841,5683,9232350,9063650,11524,18296000
30/03/2023,6043,5632,9527350,9044650,11675,18572000
31/03/2023,6271,6001,9472600,9353150,12272,18825750
04/01/2023,4960,5691,7723350,8752000,10651,16475350
04/02/2023,5275,5357,8332100,8320650,10632,16652750
04/03/2023,5438,5617,8549850,9005150,11055,17555000
04/04/2023,5636,5669,8975500,9152600,11305,18128100
04/05/2023,5691,5754,8992200,9248500,11445,18240700
04/06/2023,6198,5834,9544850,9164100,12032,18708950
04/07/2023,6658,6182,10100100,9544050,12840,19644150
04/08/2023,5469,6246,8310600,9360700,11715,17671300
04/09/2023,5674,5835,8945850,9243950,11509,18189800
04/10/2023,6121,6260,9515400,9844850,12381,19360250
04/11/2023,6067,6084,9511150,9661500,12151,19172650
04/12/2023,6238,6329,9685250,9969550,12567,19654800
13/04/2023,6856,6338,10542850,10038600,13194,20581450
14/04/2023,7606,7087,11259300,10938900,14693,22198200
15/04/2023,6081,6732,9165950,10192600,12813,19358550
16/04/2023,6448,6712,9588600,10504250,13160,20092850
17/04/2023,7713,7703,11665000,12262850,15416,23927850
18/04/2023,9609,8934,14093650,14186350,18543,28280000
19/04/2023,13725,10410,18745150,16002050,24135,34747200
20/04/2023,23049,11219,21494300,15854100,34268,37348400
21/04/2023,23464,12060,22349100,16800900,35524,39150000
22/04/2023,14064,9776,10114950,8045100,23840,18160050
23/04/2023,19277,17242,13000550,13003250,36519,26003800
24/04/2023,15478,18159,11783750,13720550,33637,25504300
25/04/2023,12833,19431,11784600,15783850,32264,27568450
26/04/2023,11707,17676,12676000,15793100,29383,28469100
27/04/2023,10946,14108,13273400,14735350,25054,28008750
28/04/2023,14037,21143,16089800,19731800,35180,35821600
29/04/2023,10348,15467,14250600,16027350,25815,30277950
30/04/2023,9802,11956,12665650,13663350,21758,26329000
05/01/2023,11809,14697,12503250,14412900,26506,26916150
05/02/2023,7847,9444,10549400,11264100,17291,21813500
05/03/2023,9130,8732,11136850,11364950,17862,22501800
05/04/2023,11703,10090,12349100,11851950,21793,24201050
05/05/2023,11969,13077,12087450,12751150,25046,24838600
05/06/2023,8609,11749,10571850,12223300,20358,22795150
05/07/2023,7563,8654,10125250,10746950,16217,20872200
05/08/2023,7872,8037,10569400,10725700,15909,21295100
05/09/2023,7813,8148,10280800,10963500,15961,21244300
05/10/2023,7749,7942,10308800,10669300,15691,20978100
05/11/2023,9561,8272,11144000,11290450,17833,22434450
05/12/2023,11898,11922,12362500,12995050,23820,25357550
13/05/2023,8011,10016,10012100,11212800,18027,21224900
14/05/2023,6984,7318,9443000,9431800,14302,18874800
15/05/2023,7291,7653,9834850,10312350,14944,20147200
16/05/2023,7664,7897,10314150,10984700,15561,21298850
17/05/2023,7401,7928,10019250,11014300,15329,21448550
18/05/2023,8991,7639,10866100,10613900,16630,21480000
19/05/2023,11785,10967,12640400,12285900,22752,24926300
20/05/2023,7914,10040,9848400,11554050,17954,21402450
21/05/2023,7456,8311,9927950,10493250,15767,20421200
22/05/2023,7762,7849,10299350,10573450,15611,20872800
23/05/2023,7251,7413,10044450,10389700,14664,20434150
24/05/2023,7555,7881,10102300,10998600,15436,21100900
25/05/2023,9748,8458,11314200,11393100,18206,22707300
26/05/2023,11944,10948,13354600,12418650,22892,25773250
27/05/2023,7955,10369,10225350,12044100,18324,22269450
28/05/2023,7946,8666,10489000,10774900,16612,21263900
29/05/2023,7509,8137,9989450,10876000,15646,20865450
30/05/2023,7611,7943,10402850,10828450,15554,21231300
31/05/2023,7630,7731,10316100,10414050,15361,20730150
06/01/2023,9804,8173,11533200,11069100,17977,22602300
06/02/2023,11285,10574,12399500,12217100,21859,24616600
06/03/2023,7748,9846,10117250,11516300,17594,21633550
06/04/2023,7542,8457,10142000,10628600,15999,20770600
06/05/2023,7674,7804,10448900,10541700,15478,20990600
06/06/2023,7514,7641,10218500,10361150,15155,20579650
06/07/2023,7419,7727,9900350,10742150,15146,20642500
06/08/2023,8840,7865,10956150,10952400,16705,21908550
06/09/2023,10032,9510,12095350,11799750,19542,23895100
06/10/2023,7484,8938,9751550,10444850,16422,20196400
06/11/2023,7523,7877,10136550,10148250,15400,20284800
06/12/2023,6869,7187,9304450,9899000,14056,19203450
13/06/2023,7466,7790,9997400,10564300,15256,20561700
14/06/2023,7380,7623,9932250,10315700,15003,20247950
15/06/2023,8539,8158,10668000,11150400,16697,21818400
16/06/2023,10724,9965,12384300,11992500,20689,24376800
17/06/2023,7783,9331,9925950,11095700,17114,21021650
18/06/2023,7552,7961,10238550,10446050,15513,20684600
19/06/2023,7738,7862,10577750,10865050,15600,21442800
20/06/2023,7719,7825,10870000,11333400,15544,22203400
21/06/2023,8281,8444,11464050,12093400,16725,23557450
22/06/2023,10044,9531,13146850,14127250,19575,27274100
23/06/2023,13067,12013,15933250,16622150,25080,32555400
24/06/2023,10276,10721,13236150,14685250,20997,27921400
25/06/2023,11731,10417,14611400,14811550,22148,29422950
26/06/2023,19727,11571,19495400,16587550,31298,36082950
27/06/2023,29897,13240,26953950,19099350,43137,46053300
28/06/2023,20829,11315,21329000,16389050,32144,37718050
29/06/2023,9977,6451,10272100,7438150,16428,17710250
30/06/2023,13928,10377,13335900,11498900,24305,24834800
07/01/2023,11865,15468,12152800,14612200,27333,26765000
07/02/2023,10897,17628,11537150,15371650,28525,26908800
07/03/2023,10862,18747,12800000,16923450,29609,29723450
07/04/2023,11091,17696,13669050,16855150,28787,30524200
07/05/2023,10515,14843,13555400,16025150,25358,29580550
07/06/2023,10821,12400,13441000,14387450,23221,27828450
07/07/2023,12820,16875,15767950,18206150,29695,33974100
07/08/2023,10051,14153,13579650,15050200,24204,28629850
07/09/2023,8363,10213,11361450,12196900,18576,23558350
07/10/2023,8310,9542,11446850,12409650,17852,23856500
07/11/2023,7878,8743,10800750,11596700,16621,22397450
07/12/2023,7901,7367,10921450,9674300,15268,20595750
13/07/2023,9468,8609,11289100,11400850,18077,22689950
14/07/2023,11435,11082,13051000,12999200,22517,26050200
15/07/2023,8394,10140,10806750,11547100,18534,22353850
16/07/2023,7856,8407,10444750,10789650,16263,21234400
17/07/2023,7868,8205,10596450,11058500,16073,21654950
18/07/2023,7718,7990,10676000,10477100,15708,21153100
19/07/2023,7530,7941,10125300,10926150,15471,21051450
20/07/2023,9811,8714,11546600,11586850,18525,23133450
21/07/2023,11632,11059,12948950,12863250,22691,25812200
22/07/2023,8196,9795,10355050,11164850,17991,21519900
23/07/2023,7723,8351,10186700,10617350,16074,20804050
24/07/2023,7793,7815,10406650,10211500,15608,20618150
25/07/2023,7760,7902,10287700,10629550,15662,20917250
26/07/2023,7964,8243,10453550,11248750,16207,21702300
27/07/2023,9507,7692,10941450,10626000,17199,21567450
28/07/2023,10383,8903,12064550,11157050,19286,23221600
29/07/2023,7803,10170,9750050,11433800,17973,21183850
30/07/2023,7234,8682,9410400,10196350,15916,19606750
31/07/2023,7267,7589,9925700,10252600,14856,20178300
08/01/2023,7533,7672,10040750,10302550,15205,20343300
08/02/2023,7310,7448,9872250,103303000,14758,20202550
08/03/2023,8797,7852,10276550,10781750,16649,21058300
08/04/2023,10007,9716,11874400,11955600,19723,23830000
08/05/2023,7536,9623,9480900,11067050,17159,20547950
08/06/2023,6927,7569,9438750,9863000,14496,19301750
08/07/2023,6375,6559,8964800,9150300,12934,18115100
08/08/2023,6352,6725,8846500,9503250,13077,18349750
08/09/2023,6853,7251,9242900,9994100,14104,19237000
08/10/2023,8710,7815,10663400,11008500,16525,21671900
08/11/2023,10127,9525,11838600,11837900,19652,23676500
08/12/2023,7311,9136,9343850,10920750,16447,20264600
13/08/2023,6835,7390,9553800,10076350,14225,19630150
14/08/2023,7507,7347,9693350,10465100,14854,20158450
15/08/2023,9492,9395,11292650,11473550,18887,22766200
16/08/2023,6432,7530,8488950,9605800,13962,18094750
17/08/2023,8618,7676,10544200,10605350,16294,21149550
18/08/2023,11169,10534,12856950,12691850,21703,25548800
19/08/2023,7420,9455,9725900,11043400,16875,20769300
20/08/2023,7262,8260,9839750,10898450,15522,20738200
21/08/2023,7336,7806,10041400,10743100,15142,20784500
22/08/2023,7377,7633,10195050,10778900,15010,20973950
23/08/2023,7717,7646,10415250,10728600,15363,21143850
24/08/2023,8929,8128,10821100,11489250,17057,22310350
25/08/2023,10792,9801,12667400,12375800,20593,25043200
26/08/2023,7236,9384,9405150,11196200,16620,20601350
27/08/2023,7120,8040,9549950,10353200,15160,19903150
28/08/2023,7302,7706,10029500,10620750,15008,20650250
29/08/2023,7544,7553,10328400,10354850,15097,20683250
30/08/2023,7635,7825,10166350,10834500,15460,21000850
31/08/2023,9388,8142,11374750,11210200,17530,22584950
09/01/2023,11095,10905,13274950,13520150,22000,26795100
09/02/2023,7927,9552,10277050,11202550,17479,21479600
09/03/2023,7108,8116,9476400,10452400,15224,19928800
09/04/2023,7546,7981,10227350,11125050,15527,21352400
09/05/2023,8516,8136,10814200,11318250,16652,22132450
09/06/2023,9385,8963,11263550,11650000,18348,22913550
09/07/2023,8765,7603,10203700,10200150,16368,20403850
09/08/2023,10869,10711,12351500,12811650,21580,25163150
09/09/2023,7695,10206,9671900,11295450,17901,20967350
09/10/2023,7550,8698,10197250,10944300,16248,21141550
09/11/2023,7517,7914,10240600,10981350,15431,21221950
09/12/2023,7438,7764,10215550,10779250,15202,20994800
13/09/2023,7878,8008,10432650,10881400,15886,21314050
14/09/2023,9575,8015,11370800,10971800,17590,22342600
15/09/2023,11461,10632,12849000,12688450,22093,25537450
16/09/2023,8072,9854,10138000,11108100,17926,21246100
17/09/2023,7658,8426,10228900,10855100,16084,21084000
18/09/2023,7429,7488,10024800,10294200,14917,20319000
19/09/2023,7209,7304,9910850,10142000,14513,20052850
20/09/2023,7259,7442,10037550,10452650,14701,20490200
21/09/2023,8183,7584,10140450,10782350,15767,20922800
22/09/2023,10355,9522,12149450,11754750,19877,23904200
23/09/2023,7148,8919,9184750,10640050,16067,19824800
24/09/2023,7160,7827,9766400,10081350,14987,19847750
25/09/2023,7497,7802,10158100,10735650,15299,20893750
26/09/2023,7792,7683,10702800,10517950,15475,21220750
27/09/2023,10693,8524,12144350,11875650,19217,24020000
28/09/2023,14518,10493,15528600,13584600,25011,29113200
29/09/2023,10370,10136,12009450,11131950,20506,23141400
30/09/2023,8218,12673,10613850,13524800,20891,24138650
10/01/2023,7959,9280,10765050,11543700,17239,22308750
10/02/2023,7943,8330,10860050,11132400,16273,21992450
10/03/2023,7439,7824,10439200,10870850,15263,21310050
10/04/2023,7227,7262,10139050,10479700,14489,20618750
10/05/2023,7850,7305,10370050,10399500,15155,20769550
10/06/2023,8541,8875,10744400,11772300,17416,22516700
10/07/2023,7113,8411,9405300,10373950,15524,19779250
10/08/2023,7305,8032,9822050,10408550,15337,20230600
10/09/2023,7813,7792,10288850,10609800,15605,20898650
10/10/2023,7382,7671,9871500,10460650,15053,20332150
10/11/2023,7925,8384,10577600,11620200,16309,22197800
10/12/2023,9605,8278,11313250,11343200,17883,22656450
13/10/2023,11271,10582,12755750,12932750,21853,25688500
14/10/2023,7864,9689,10102500,11115400,17553,21217900
15/10/2023,7801,8476,10505650,10778100,16277,21283750
16/10/2023,7867,8126,10711100,11276150,15993,21987250
17/10/2023,7944,7959,10761400,11030000,15903,21791400
18/10/2023,8115,8131,10714700,11582900,16246,22297600
19/10/2023,10856,8690,12404250,12043650,19546,24447900
20/10/2023,13590,11018,14836600,13764850,24608,28601450
21/10/2023,9153,9934,11023700,11573350,19087,22597050
22/10/2023,8755,8837,10892750,11064950,17592,21957700
23/10/2023,8912,8412,11078400,11046700,17324,22125100
24/10/2023,9502,9969,11587900,11864500,19471,23452400
25/10/2023,7548,9159,9993050,11204150,16707,21197200
26/10/2023,9497,8974,11383900,11793050,18471,23176950
27/10/2023,10503,11012,12867350,13400050,21515,26267400
28/10/2023,5560,5872,7514700,6927350,11432,14442050
29/10/2023,4394,5962,5617300,7007150,10356,12624450
30/10/2023,8616,10203,11596550,13025100,18819,24621650
31/10/2023,5695,4573,7630250,5901950,10268,13532200
11/01/2023,4767,4465,5452500,5480850,9232,10933350
11/02/2023,7056,5998,7273000,7932050,13054,15205050
11/03/2023,11192,11514,13244700,14633000,22706,27877700
11/04/2023,8860,11374,11346500,13143300,20234,24489800
11/05/2023,5725,5279,7500550,6241150,11004,13741700
11/06/2023,5143,5271,6066050,6438350,10414,12504400
11/07/2023,7151,9261,9310200,12445050,16412,21755250
11/08/2023,6021,5667,7789700,7393050,11688,15182750
11/09/2023,7916,6434,8341450,8388200,14350,16729650
11/10/2023,11751,11478,13226950,13810650,23229,27037600
11/11/2023,8524,10851,10978600,12348300,19375,23326900
11/12/2023,6231,6285,7850300,7589000,12516,15439300
13/11/2023,5640,6264,6712500,7590200,11904,14302700
14/11/2023,7767,7563,10065400,9673150,15330,19738550
15/11/2023,6454,6268,8167750,8086300,12722,16254050
16/11/2023,7434,6121,8057650,8160750,13555,16218400
17/11/2023,8662,8540,11475500,11560500,17202,23036000
18/11/2023,7593,9998,9602950,11633900,17591,21236850
19/11/2023,6109,6183,7937700,7440800,12292,15378500
20/11/2023,5996,6439,7341500,8115600,12435,15457100
21/11/2023,7646,8225,9954350,11042950,15871,20997300
22/11/2023,6383,6245,8158350,8311100,12628,16469450
23/11/2023,8309,6928,9073350,9129900,15237,18203250
24/11/2023,11375,10702,13138350,13068650,22077,26207000
25/11/2023,8398,10764,10596450,12203650,19162,22800100
26/11/2023,6581,6917,8132550,8233750,13498,16366300
27/11/2023,6672,6721,8105500,8670650,13393,16776150
28/11/2023,8400,8392,10610750,11019050,16792,21629800
29/11/2023,7385,7075,9312550,9087600,14460,18400150
30/11/2023,9121,7488,10047450,9734800,16609,19782250
12/01/2023,12775,11920,14639350,14323450,24695,28962800
12/02/2023,8655,10946,10907700,12514950,19601,23422650
12/03/2023,6998,7732,8778750,9033800,14730,17812550
12/04/2023,6827,7496,8585950,9537950,14323,18123900
12/05/2023,8720,8524,11275250,11309800,17244,22585050
12/06/2023,7627,7361,9554500,9683350,14988,19237850
12/07/2023,7992,6462,10020300,9094900,14454,19115200
12/08/2023,10564,10324,12432500,13033350,20888,25465850
12/09/2023,8303,10422,104076500,12082150,18725,22489800
12/10/2023,7577,8219,9809300,10322500,15796,20131800
12/11/2023,7811,8141,10190450,10869300,15952,21059750
12/12/2023,8012,7947,10382950,10393900,15959,20776850
13/12/2023,8296,7883,10490850,10730000,16179,21220850
14/12/2023,12994,8997,13798550,12409000,21991,26207550
15/12/2023,15985,11831,17498850,15055500,27816,32554350
16/12/2023,9775,13949,11658400,14563850,23724,26222250
17/12/2023,8213,11320,11071050,12728050,19533,23799100
18/12/2023,8267,9128,11131950,11696250,17395,22828200
19/12/2023,7821,8080,10408250,10715250,15901,21123500
20/12/2023,8792,8704,11464650,11685050,17496,23149700
21/12/2023,11327,8793,13070550,12121000,20120,25191550
22/12/2023,13595,11351,15368450,13804950,24946,29173400
23/12/2023,9279,10979,11766100,13107500,20258,24873600
24/12/2023,8503,8466,10729100,10479250,16969,21208350
25/12/2023,10336,11680,12785700,14077750,22016,26863450
26/12/2023,8423,8877,11078100,11026700,17300,22104800
27/12/2023,8599,8656,11180950,11378950,17255,22559900
28/12/2023,10673,8732,12487800,11626900,19405,24114700
29/12/2023,12244,11031,14192650,13108600,23275,27301250
30/12/2023,8475,11363,11119450,13138750,19838,24258200
31/12/2023,8425,9241,11162350,11336800,17666,22499150
01/01/2024,8237,8042,10800700,10473250,16279,21273950
01/02/2024,8717,7932,11473150,11029850,16649,22503000
01/03/2024,8303,8892,10619250,12149400,17195,22768650
01/04/2024,12182,8397,13326200,12142400,20579,25468600
01/05/2024,12890,8833,14796350,12586300,21723,27382650
01/06/2024,4594,3104,6057350,4277750,7698,10335100
01/07/2024,1528,2253,1773650,2246150,3781,4019800
01/08/2024,4773,10419,6654250,10758700,15192,17412950
01/09/2024,6902,10998,9725150,12585000,17900,22310150
01/10/2024,8003,9641,11312650,12549250,17644,23861900
01/11/2024,9653,8783,12194400,11899350,18436,24093750
01/12/2024,10838,10709,13358050,13174600,21547,26532650
13/01/2024,7772,10073,10598250,11840200,17845,22438450
14/01/2024,7439,8471,10580300,11321200,15910,21901500
15/01/2024,8064,8124,11325000,11263000,16188,22588000
16/01/2024,8135,8529,11096200,11797550,16664,22893750
17/01/2024,8100,8125,11330450,11522550,16225,22853000
18/01/2024,9533,7967,11909700,11577500,17500,23487200
19/01/2024,10736,10271,13305200,12942700,21007,26247900
20/01/2024,8218,10066,10788100,12005900,18284,22794000
21/01/2024,8105,8757,11028550,11440650,16862,22469200
22/01/2024,7926,8157,10993950,11040150,16083,22034100
23/01/2024,7918,8151,10960700,11324200,16069,22284900
24/01/2024,8202,8020,11225500,11273200,16222,22498700
25/01/2024,9846,8652,11853450,12255600,18498,24109050
26/01/2024,11458,10624,13804850,13401450,22082,27206300
27/01/2024,8400,10443,11026700,12349400,18843,23376100
28/01/2024,7892,8715,10822500,11146300,16607,21968800
29/01/2024,8059,8438,11013600,11562350,16497,22575950
30/01/2024,8226,8303,11335500,11449950,16529,22785450
31/01/2024,8581,8635,11620950,12002250,17216,23623200
02/01/2024,10374,8869,12368800,12336250,19243,24705050
02/02/2024,11476,10574,13922900,13297400,22050,27220300
02/03/2024,8173,10329,10413600,11930650,18502,22344250
02/04/2024,8622,9045,11622950,11131950,17667,22754900
02/05/2024,8140,7035,11048250,8888250,15175,19936500
02/06/2024,8616,8687,11641900,12060200,17303,23702100
02/07/2024,8704,8777,11558050,12230100,17481,23788150
02/08/2024,11226,9326,13100550,13049050,20552,26149600
02/09/2024,12147,11579,14463000,14544900,23726,29007900
02/10/2024,8651,10964,11135000,12667750,19615,23802750
02/11/2024,8769,9409,12063950,11859300,18178,23923250
02/12/2024,9167,8975,12597900,12152600,18142,24750500
13/02/2024,8701,9335,11703250,12800500,18036,24503750
14/02/2024,8719,8847,11763200,12363450,17566,24126650
15/02/2024,10474,8864,12596600,12321250,19338,24917850
16/02/2024,12365,11020,14696000,13571850,23385,28267850
17/02/2024,9200,10751,11975300,12278400,19951,24253700
18/02/2024,8524,9354,11568950,11940950,17878,23509900
19/02/2024,9594,9022,12558250,12181100,18616,24739350
20/02/2024,10605,10652,13016300,14868500,21257,27884800
21/02/2024,12349,10831,14429550,13717400,23180,28146950
22/02/2024,9011,8399,10214650,10632300,17410,20846950
23/02/2024,11040,11236,13065150,13230050,22276,26295200
24/02/2024,7626,10214,9563200,11277950,17840,20841150
25/02/2024,8685,7660,11159900,9380800,16345,20540700
26/02/2024,8162,9078,10168600,10618450,17240,20787050
27/02/2024,7558,8563,9921200,10314500,16121,20235700
28/02/2024,8311,8239,10962750,10942550,16550,21905300
29/02/2024,9911,8607,11742400,11436700,18518,23179100
03/01/2024,10927,9934,12869200,12216650,20861,25085850
03/02/2024,8672,10398,11058750,11941000,19070,22999750
03/03/2024,8226,9307,10921400,11529500,17533,22450900
03/04/2024,7723,8337,9949800,11108150,16060,21057950
03/05/2024,8652,8396,11357300,11069400,17048,22426700
03/06/2024,8769,8830,11380400,11772750,17599,23153150
03/07/2024,11003,9103,12904950,12227300,20106,25132250
03/08/2024,11287,10346,12850800,12554950,21633,25405750
03/09/2024,9378,11733,11758200,13334200,21111,25092400
03/10/2024,9153,10321,12152950,12575250,19474,24728200
03/11/2024,8888,9366,12232000,12287450,18254,24519450
03/12/2024,7232,7130,10422800,10432250,14362,20855050
13/03/2024,7044,7308,9950650,10401900,14352,20352550
14/03/2024,8468,7349,10770050,10482050,15817,21252100
15/03/2024,8714,7647,11054550,10471100,16361,21525650
16/03/2024,6873,7697,9129850,9947500,14570,19077350
17/03/2024,6985,8239,9758600,10429250,15224,20187850
18/03/2024,6557,7463,9221750,9594000,14020,18815750
19/03/2024,7086,7114,10210450,10097800,14200,20308250
20/03/2024,7068,7076,10031950,10195950,14144,20227900
21/03/2024,7981,7318,10448350,10530550,15299,20978900
22/03/2024,8440,7711,10851800,10251850,16151,21103650
23/03/2024,6467,7936,8733900,10017050,14403,18750950
24/03/2024,6837,7265,9302450,9901400,14102,19203850
25/03/2024,7497,7260,10211750,10372500,14757,20584250
26/03/2024,7836,7702,10512450,10522600,15538,21035050
27/03/2024,7011,7378,9256750,9718350,14389,18975100
28/03/2024,8308,7738,10862900,10753600,16046,21616500
29/03/2024,9175,8496,11319450,11806750,17671,23126200
30/03/2024,7267,8189,9741500,10449900,15456,20191400
31/03/2024,7317,7409,10178900,9894950,14726,20073850
04/01/2024,7640,7561,10494250,10808800,15201,21303050
04/02/2024,7823,7977,10675100,11330850,15800,22005950
04/03/2024,8276,8266,11007900,11710300,16542,22718200
04/04/2024,11186,9233,13125100,13260250,20419,26385350
04/05/2024,14865,10826,16341300,15284100,25691,31625400
04/06/2024,11437,9375,13217350,12602900,20812,25820250
04/07/2024,13529,9777,15316900,13565800,23306,28882700
04/08/2024,20851,10949,20587850,15161700,31800,35749550
04/09/2024,30330,14874,27637900,21356800,45204,48994700
04/10/2024,17705,8510,16070350,11589500,26215,27659850
04/11/2024,11194,7465,9141800,7523200,18659,16665000
04/12/2024,15883,12100,13818700,12505450,27983,26324150
13/04/2024,12896,15596,12049100,14359900,28492,26409000
14/04/2024,11625,23301,13374250,19598050,34926,32972300
15/04/2024,12133,23380,15413800,20420650,35513,35834450
16/04/2024,11634,19642,16077450,19699050,31276,35776500
17/04/2024,11048,15715,15118950,16966900,26763,32085850
18/04/2024,11238,13261,14395700,15374200,24499,29769900
19/04/2024,12222,15987,16007850,17932650,28209,33940500
20/04/2024,9888,13566,13484950,14942100,23454,28427050
21/04/2024,8964,10383,12168500,12853100,19347,25021600
22/04/2024,8536,9411,11686050,12402050,17947,24088100
23/04/2024,8198,9027,11191250,12149500,17225,23340750
24/04/2024,8397,8890,11269750,11882550,17287,23152300
25/04/2024,9607,8798,11740450,11960350,18405,23700800
26/04/2024,10631,10306,12976850,12918850,20937,25895700
27/04/2024,8294,10002,10851250,11812750,18296,22664000
28/04/2024,8158,8696,10848150,10996500,16854,21844650
29/04/2024,7962,8316,10713850,11213400,16278,21927250
30/04/2024,10062,8503,12590300,11721800,18565,24312100
05/01/2024,9540,9819,11388700,12271900,19359,23660600
05/02/2024,8667,8436,10020800,10898700,17103,20919500
05/03/2024,9934,10132,12100900,12615450,20066,24716350
05/04/2024,8065,10107,10546350,11766750,18172,22313100
05/05/2024,7962,8714,10537750,10939250,16676,21477000
05/06/2024,7887,7620,10720700,10776900,15507,21497600
05/07/2024,8021,7689,10501850,10736400,15710,21238250
05/08/2024,7343,7572,9857850,10405700,14915,20263550
05/09/2024,9613,8819,11548900,11821100,18432,23370000
05/10/2024,10489,10593,12274350,12782350,21082,25056700
05/11/2024,7940,9983,10367800,11862600,17923,22230400
05/12/2024,8043,8689,11046900,11044350,16732,22091250
13/05/2024,8093,8574,10912750,11657000,16667,22569750
14/05/2024,8264,8490,11175600,11698850,16754,22874450
15/05/2024,8301,8641,10949400,11903850,16942,22853250
16/05/2024,10157,8662,11887650,11764300,18819,23651950
17/05/2024,11164,10501,13025400,12981700,21665,26007100
18/05/2024,8158,10042,10458050,11467250,18200,21925300
19/05/2024,8169,8723,10806250,11128450,16892,21934700
20/05/2024,8402,8299,10827700,11280850,16701,22108550
21/05/2024,8480,8178,10841000,10898150,16658,21739150
22/05/2024,8845,9404,11136650,11595250,18249,22731900
23/05/2024,9320,8519,11279500,11122250,17839,22401750
24/05/2024,10675,10585,12653550,12966950,21260,25620500
25/05/2024,8241,10380,10879850,11978100,18621,22857950
26/05/2024,7562,8322,10236150,10863400,15884,21099550
27/05/2024,5643,4780,8283200,6811100,10423,15094300
28/05/2024,6237,6632,7838850,8697050,12869,16535900
29/05/2024,7845,8320,10443750,11344000,16165,21787750
30/05/2024,9250,8795,11257700,11652600,18045,22910300
31/05/2024,10709,10496,12797600,12876950,21205,25674550
06/01/2024,8094,9550,10522000,11463800,17644,21985800
06/02/2024,7923,8464,10616800,10921950,16387,21538750
06/03/2024,8291,8467,11183150,11703150,16758,22886300
06/04/2024,8338,8475,11283750,11683000,16813,22966750
06/05/2024,8225,8463,11154650,11726950,16688,22881600
06/06/2024,9247,8890,11671700,12045050,18137,23716750
06/07/2024,10807,10104,13385100,12846400,20911,26231500
06/08/2024,8579,9594,11146350,12038600,18173,23184950
06/09/2024,8945,9054,12132000,12178050,17999,24310050
06/10/2024,9190,9585,12419850,13562600,18775,25982450
06/11/2024,9952,10110,13518700,14637450,20062,28156150
06/12/2024,11573,11110,15072400,16102300,22683,31174700
13/06/2024,17824,12672,18543850,18093050,30496,36636900
14/06/2024,28896,15137,27264550,20765550,44033,48030100
15/06/2024,25453,13573,24313950,18597350,39026,42911300
16/06/2024,20792,10710,20802800,14711400,31502,35514200
17/06/2024,10453,6988,9305400,7411150,17441,16716550
18/06/2024,15067,13184,13809950,13312050,28251,27122000
19/06/2024,13005,15322,12774300,14289250,28327,27063550
20/06/2024,11335,14435,12026000,14264150,25770,26290150
21/06/2024,12867,22977,15342250,20419800,35844,35762050
22/06/2024,12418,24437,16363350,21528900,36855,37892250
23/06/2024,11471,17532,15680550,17874150,29003,33554700
24/06/2024,10486,13981,14334550,15808900,24467,30143450
25/06/2024,9883,12320,13562850,14692000,22203,28254850
26/06/2024,9213,10567,12723050,13244600,19780,25967650
27/06/2024,10042,9768,12389150,12587650,19810,24976800
28/06/2024,11806,12447,14483750,14788900,24253,29272650
29/06/2024,8716,10782,11860950,12645650,19498,24506600
30/06/2024,8413,8903,11786650,11446500,17316,23233150
07/01/2024,8069,8480,11348350,11647150,16549,22995500
07/02/2024,7603,7844,10670350,10780600,15447,21450950
07/03/2024,7643,8090,10345100,11148550,15733,21493650
07/04/2024,9399,7956,11435700,10932400,17355,22368100
07/05/2024,9980,9950,12375300,12468550,19930,24843850
07/06/2024,7983,9712,10364550,11587150,17695,21951700
07/07/2024,7884,8341,10758550,10502400,16225,21260950
07/08/2024,8016,8400,10701150,11259750,16416,21960900
07/09/2024,8089,8147,10957350,11030950,16236,21988300
07/10/2024,7920,7931,10713250,10988750,15851,21702000
07/11/2024,9656,8310,11665700,11615600,17966,23281300
07/12/2024,9645,9736,11808750,12600050,19381,24408800
13/07/2024,9656,8310,11665700,11615600,17966,23281300
14/07/2024,8335,8705,11167150,11026700,17040,22193850
15/07/2024,7972,8258,10672050,11143050,16230,21815100
16/07/2024,9092,8025,11505550,10971000,17117,22476550
17/07/2024,8478,7996,10357600,10707050,16474,21064650
18/07/2024,5400,4646,5985050,5924500,10046,11909550
19/07/2024,4037,3933,3840800,4304650,7970,8145450
20/07/2024,2256,2188,2534400,2185100,4444,4719500
21/07/2024,2489,2217,2295250,2388500,4706,4683750
22/07/2024,3495,3097,3511400,3333000,6592,6844400
23/07/2024,4270,3976,4478000,4621100,8246,9099100
24/07/2024,5509,6809,6974150,7663000,12318,14637150
25/07/2024,7365,6918,9086100,9080350,14283,18166450
26/07/2024,8144,8059,10595850,10586600,16203,21182450
27/07/2024,6616,8177,9028850,9829800,14793,18858650
28/07/2024,6890,7492,9674550,9560400,14382,19234950
29/07/2024,7034,7382,9708900,10314000,14416,20022900
30/07/2024,7009,7044,9761650,9969600,14053,19731250
31/07/2024,7169,7010,9992500,9873300,14179,19865800
08/01/2024,7835,6642,9941150,9588000,14477,19529150
08/02/2024,7397,6989,9721150,9582650,14386,19303800
08/03/2024,5670,7048,7422650,8738500,12718,16161150
08/04/2024,4277,3101,4676200,3591600,7378,8267800
08/05/2024,3495,2765,2704000,2817750,6260,5521750
08/06/2024,6251,5410,5412550,5270750,11661,10683300
08/07/2024,6634,7154,7121350,7905400,13788,15026750
08/08/2024,7960,7264,8727250,9150050,15224,17877300
08/09/2024,8094,8671,9079850,10096300,16765,19176150
08/10/2024,6480,8864,8157350,9469250,15344,17626600
08/11/2024,6644,7774,8952850,9339250,14418,18292100
08/12/2024,7076,7811,9432550,10047500,14887,19480050
13/08/2024,7375,7663,9702650,9966100,15038,19668750
14/08/2024,8026,7815,10059250,10384350,15841,20443600
15/08/2024,9040,7100,9998900,9655750,16140,19654650
16/08/2024,9968,9887,11258900,11823200,19855,23082100
17/08/2024,7274,9969,9120350,11014550,17243,20134900
18/08/2024,7273,8756,9823400,10487400,16029,20310800
19/08/2024,7441,7743,10166800,10141700,15184,20308500
20/08/2024,7644,8119,10022250,10568050,15763,20590300
21/08/2024,7375,7560,9744600,10379500,14935,20124100
22/08/2024,8746,7552,10397100,10197250,16298,20594350
23/08/2024,9861,9248,11287200,11295750,19109,22582950
24/08/2024,7034,8977,8391700,10140850,16011,18532550
25/08/2024,7028,7311,9137850,9326550,14339,18464400
26/08/2024,7474,8076,9833350,10018750,15550,19852100
27/08/2024,7177,7629,9448500,9668650,14806,19117150
28/08/2024,7665,8012,9970550,10546100,15677,20516650
29/08/2024,9758,8278,11056050,10941100,18036,21997150
30/08/2024,11272,10566,12909700,12499650,21838,25409350
31/08/2024,7900,10194,9899000,11419250,18094,21318250
09/01/2024,8045,8579,10179750,10386050,16624,20565800
09/02/2024,7832,8432,10244500,10899000,16264,21143500
09/03/2024,8013,8136,10286800,10491000,16149,20777800
09/04/2024,8169,8292,10281050,10704100,16461,20985150
09/05/2024,10140,8574,11081100,10984800,18714,22065900
09/06/2024,11857,10935,12773250,12297400,22792,25070650
09/07/2024,8070,10664,9826000,11470750,18734,21296750
09/08/2024,8030,9033,10161200,10616150,17063,20777350
09/09/2024,7971,8482,10450250,10857200,16453,21307450
09/10/2024,8188,8463,10536200,10950750,16651,21486950
09/11/2024,8408,8431,10598800,10929200,16839,21528000
09/12/2024,10649,8841,11377000,11455750,19490,22832750
13/09/2024,12322,10879,13331350,12557450,23201,25888800
14/09/2024,6874,8137,9166650,9684400,15011,18851050
15/09/2024,6511,6503,9019150,8330500,13014,17349650
16/09/2024,7567,8994,9362200,10540950,16561,19903150
17/09/2024,7167,8340,8728750,9620100,15507,18348850
18/09/2024,7885,8481,10087350,11053350,16366,21140700
19/09/2024,10058,8750,11108150,11389200,18808,22497350
20/09/2024,11644,10813,12805750,12296100,22457,25101850
21/09/2024,7981,9883,9848300,10675850,17864,20524150
22/09/2024,7963,8676,10079250,10375650,16639,20454900
23/09/2024,8155,8650,10585450,10973700,16805,21559150
24/09/2024,8220,8251,10451700,10483750,16471,20935450
25/09/2024,7719,7437,10414200,10038150,15156,20452350
26/09/2024,8259,7466,10236050,10345600,15725,20581650
27/09/2024,10277,9486,12212800,11447650,19763,23660450
28/09/2024,7892,9611,9731050,10812900,17503,20543950
29/09/2024,8124,8681,10552500,10672800,16805,21225300
30/09/2024,8153,8592,10683500,11219950,16745,21903450
10/01/2024,8236,8447,10714350,11235700,16683,21950050
10/02/2024,7944,7942,10389300,10543350,15886,20932650
10/03/2024,8924,7738,10629750,10489400,16662,21119150
10/04/2024,10352,9418,12375900,11656500,19770,24032400
10/05/2024,7059,8658,9321800,10246500,15717,19568300
10/06/2024,7488,8237,9550300,10155200,15725,19705500
10/07/2024,8146,8337,10470950,10920200,16483,21391150
10/08/2024,8752,8494,10913900,11496450,17246,22410350
10/09/2024,11192,8659,12557050,11713950,19851,24271000
10/10/2024,16811,10396,16237700,13824000,27207,30061700
10/11/2024,14695,11324,15292750,13111500,26019,28404250
10/12/2024,9012,10157,10140000,10804350,19169,20944350
13/10/2024,8804,13555,10691450,13251500,22359,23942950
14/10/2024,8286,11875,10746650,11947500,20161,22694150
15/10/2024,8844,9977,11502650,12008700,18821,23511350
16/10/2024,9121,9662,11715150,12070800,18783,23785950
17/10/2024,10303,8943,12054850,11680150,19246,23735000
18/10/2024,11484,11171,13366650,13175650,22655,26542300
19/10/2024,8494,10773,10872450,11906800,19267,22779250
20/10/2024,8318,9116,10993000,11032550,17434,22025550
21/10/2024,8191,8741,10938700,11413150,16932,22351850
22/10/2024,8356,8402,10861700,11230350,16758,22092050
23/10/2024,8313,8330,10920600,11165400,16643,22086000
24/10/2024,8804,7884,10982550,10885250,16688,21867800
25/10/2024,10218,9162,11672050,11158500,19380,22830550
26/10/2024,7852,9424,9748200,10519700,17276,20267900
27/10/2024,7918,8286,10487500,10051250,16204,20538750
28/10/2024,8101,8448,10657550,11124600,16549,21782150
29/10/2024,8329,8240,10846950,10839750,16569,21686700
30/10/2024,8565,8485,11086000,113348000,17050,22420800
31/10/2024,10616,8587,11882250,11333950,19203,23216200
11/01/2024,11578,10372,12792650,12792650,21950,24772050
11/02/2024,8068,10293,10041900,11188300,18361,21230200
11/03/2024,8059,9062,10234000,10762650,17121,20996650
11/04/2024,8412,8572,10952800,10900550,16984,21853350
11/05/2024,8502,8929,11268100,11819500,17431,23087600
11/06/2024,8079,8357,10302300,11023450,16436,21325750
11/07/2024,10958,8641,11978500,11314650,19599,23293150
11/08/2024,11564,10667,13120100,12716550,22231,25836650
11/09/2024,8218,10544,10158500,11265700,18762,21424200
11/10/2024,7976,8964,10309800,10721650,16940,21031450
11/11/2024,8290,8621,10697950,10974600,16911,21672550
11/12/2024,8093,8377,10596100,10889200,16470,21485300
13/11/2024,8622,8420,11100550,11170550,17042,22271100
13/11/2024,10815,8709,11987100,11375150,19524,23362250
15/11/2024,12082,10909,13586900,12797950,22991,26384850
16/11/2024,8585,10694,10238800,11625000,19279,21863800
17/11/2024,8226,9301,10618200,11097500,17527,21715700
18/11/2024,8290,8817,10766450,11371850,17107,22138300
19/11/2024,8321,8324,10853200,10827250,16645,21680450
20/11/2024,8736,8658,11180200,11099850,17394,22280050
21/11/2024,10418,8889,11914600,11767750,19307,23682350
22/11/2024,11420,10765,12904500,12827500,22185,25732000
23/11/2024,8059,10566,9934450,11504850,18625,21439300
24/11/2024,8220,8812,10589550,10836750,17032,21426300
25/11/2024,8417,8594,10841000,11165200,17011,22006200
26/11/2024,8323,8314,10780650,10703000,16637,21483650
27/11/2024,8455,8591,10718300,11214600,17046,21932900
28/11/2024,10160,8660,11769700,11373350,18820,23143050
29/11/2024,11358,10457,13018800,12432650,21815,25451450
30/11/2024,8174,10183,10298800,11483300,18357,21782100
12/01/2024,8003,8985,10240500,10999600,16988,21240100
12/02/2024,7937,8702,10304150,11339750,16639,21643900
12/03/2024,7978,8215,10359450,10826950,16193,21186400
12/04/2024,8084,8340,10341500,10874900,16424,21216400
12/05/2024,10391,8468,11503800,10972600,18859,22476400
12/06/2024,11099,10391,12774000,12526550,21490,25300550
12/07/2024,8006,10073,9888000,11134050,18079,21022050
12/08/2024,8044,8880,10237850,10786050,16924,21023900
12/09/2024,8087,8318,10805100,10852250,16405,21657350
12/10/2024,8402,8323,10991550,11115800,16725,22107350
12/11/2024,8738,8642,11057250,11537550,17380,22594800
12/12/2024,11846,9319,13293350,12531650,21165,25825000
13/12/2024,13645,11283,15495400,13997950,24928,29493350
14/12/2024,9203,10536,11215150,12112800,19739,23327950
15/12/2024,10259,9466,12211000,11743800,19725,23954800
16/12/2024,11268,11900,13515600,13630450,23168,27146050
17/12/2024,8702,10365,10847250,12392650,19067,23239900
18/12/2024,9808,9813,12509900,12541100,19621,25051000
19/12/2024,12078,9546,13687250,12543450,21624,26230700
20/12/2024,13335,11972,15237550,14468500,25307,29706050
21/12/2024,9452,11478,11888650,12929900,20930,24818550
22/12/2024,9595,10279,12182650,12346550,19874,24529200
23/12/2024,9883,10032,12498600,12780350,19915,25278950
24/12/2024,11296,9899,13438350,12924500,21195,26362850
25/12/2024,12671,11107,14798900,14074150,23778,28873050
26/12/2024,11415,9427,12971800,11655550,20842,24627350
27/12/2024,12846,12814,14952250,15068500,25660,30020750
28/12/2024,9880,13339,12549050,14259950,23219,26809000
29/12/2024,9363,10859,12345700,12911350,20222,25257050
30/12/2024,9585,10309,12674250,13002100,19894,25676350
31/12/2024,9669,9774,12608200,12615500,19443,25223700
01/01/2025,9381,9088,12214850,11750700,18469,23965550
01/02/2025,10286,8982,12514500,12090050,19268,24604550
01/03/2025,10670,10317,13367350,13089250,20987,26456600
01/04/2025,8272,10677,10700950,12312750,18949,23013700
01/05/2025,8616,9211,11432050,11382450,17827,#VALUE!
01/06/2025,8480,9025,11317600,11774900,17505,23092500
01/07/2025,8652,8823,11575350,11815150,17475,23390500
01/08/2025,8794,8725,11638700,11733250,17519,23371950
01/09/2025,11012,9220,12603850,12315150,20232,24919000
01/10/2025,13041,11089,15065550,13605400,24130,28670950
01/11/2025,8858,12198,11188350,13686700,21056,24875050
01/12/2025,8775,9491,11685850,11438050,18266,23123900
13/01/2025,8720,9261,11554900,12170950,17981,23725850
14/01/2025,9638,8798,12789500,11850350,18436,24639850
15/01/2025,9062,9914,11788100,13225900,18976,25014000
16/01/2025,11376,9129,12883250,12176400,20505,25059650
17/01/2025,12250,11545,14351800,13951600,23795,28303400
18/01/2025,8711,11007,10812800,12268500,19718,23081300
19/01/2025,8746,9434,11341500,11368450,18180,22709950
20/01/2025,8836,9187,11641000,11918150,18023,23559150
21/01/2025,8732,8683,11526300,11455250,17415,22981550
22/01/2025,8963,8921,11884800,11682900,17884,23567700
23/01/2025,11019,9190,12742550,12294950,20209,25037500
24/01/2025,12014,11106,14207000,13586950,23120,27793950
25/01/2025,8942,10870,11316400,12330900,19812,23647300
26/01/2025,8904,9448,11516200,11732300,18352,23248500
27/01/2025,8989,9282,11845600,11905450,18271,23751050
28/01/2025,8929,8989,11808000,11939400,17918,23747400
29/01/2025,8850,9305,11538400,12339250,18155,23877650
30/01/2025,11064,9226,13134950,12478100,20290,25613050
31/01/2025,11947,10893,14028050,13462550,22840,27490600
02/01/2025,9073,10997,11353100,12536450,20070,23889550
02/02/2025,8969,9998,11653250,12350700,18967,24003950
02/03/2025,8719,9622,11371450,12423700,18341,23795150
02/04/2025,9347,9466,12413500,12352400,18813,24765900
02/05/2025,9414,9297,12292200,12032000,18711,24324200
02/06/2025,11401,9286,12940150,12154150,20687,25094300
02/07/2025,11975,11402,14004150,13958300,23377,27962450
02/08/2025,8822,11205,11070250,12364700,20027,23434950
02/09/2025,8944,9744,11710400,11905550,18688,23615950
02/10/2025,9498,9123,12647150,11828700,18621,24475850
02/11/2025,9284,9845,12269450,13203150,19129,25472600
02/12/2025,9544,9357,12450800,12549000,18901,24999800
13/02/2025,12850,10113,14411600,13730550,22963,28142150
14/02/2025,13522,10649,16168400,13722150,24171,29890550
15/02/2025,9396,12048,11602300,13050800,21444,24653100
16/02/2025,9484,11242,12484400,12393900,20726,24878300
17/02/2025,10619,10430,13922600,13230700,21049,27153300
18/02/2025,9369,11163,12630150,15160700,20532,27790850
19/02/2025,9844,9671,12707500,12656200,19515,25363700
20/02/2025,12267,9843,14212750,13115150,22110,27327900
21/02/2025,13198,12187,15264250,14525650,25385,29789900
22/02/2025,9130,12264,11528250,13606500,21394,25134750
23/02/2025,9330,10435,11999500,12537550,19765,24537050
24/02/2025,9497,10050,12387300,12974100,19547,25361400
25/02/2025,9924,10035,12888000,13234950,19959,26122950
26/02/2025,10148,10228,13026850,13113650,20376,26140500
27/02/2025,11406,10718,13718450,14038300,22124,27756750
28/02/2025,12063,11726,14696250,14514850,23789,29211100
03/01/2025,9065,10992,11961500,12841950,20057,24803450
03/02/2025,7487,7735,10568300,10289400,15222,20857700
03/03/2025,7445,7619,10243250,10334000,15064,20577250
03/04/2025,7446,7682,10371450,10471800,15128,20843250
03/05/2025,7708,7802,10472700,10707250,15510,21179950
03/06/2025,9063,7961,11038450,10828350,17024,21866800
03/07/2025,8597,8127,11169900,10698600,16724,21868500
03/08/2025,6804,8357,8983750,9920700,15161,18904450
03/09/2025,7356,7766,9952650,9933850,15122,19886500
03/10/2025,7390,7779,10034750,10678100,15169,20712850
03/11/2025,7643,7629,10391200,10435100,15272,20826300
03/12/2025,7561,7737,10246200,10723100,15298,20969300
13/03/2025,8930,7980,11078700,10783700,16910,21862400
14/03/2025,8772,8553,10871350,11304650,17325,22176000
15/03/2025,7194,8511,9478750,10203950,15705,19682700
16/03/2025,7551,7907,10017100,10093150,15458,20110250
17/03/2025,7765,7904,10475950,10752000,15669,21227950
18/03/2025,7923,7779,10702650,10565000,15702,21267650
19/03/2025,7963,8062,10673450,11015800,16025,21689250
20/03/2025,9094,8493,11570800,11645150,17587,23215950
21/03/2025,9847,8752,12461450,11568050,18599,24029500
22/03/2025,7964,8812,10103050,11106200,16776,21209250
23/03/2025,8423,8261,10923800,10914950,16684,21838750
24/03/2025,9285,8830,12039700,12419350,18115,24459050
25/03/2025,11678,9977,13727150,14079350,21655,27806500
26/03/2025,14992,11436,16319450,15994400,26428,32313850
27/03/2025,17335,10348,16810450,13957400,27683,30767850
28/03/2025,26057,13580,23728300,18813000,39637,42541300
29/03/2025,24305,12619,23329450,17462750,36924,40792200
30/03/2025,22965,11276,21154000,15590900,34241,36744900
31/03/2025,11620,7798,9644750,7855250,19418,17500000
04/01/2025,14892,11118,12887250,11501150,26010,24388400
04/02/2025,12864,13091,11772400,12055500,25955,23827900
04/03/2025,11931,16192,12190300,14673300,28123,26863600
04/04/2025,12707,25000,15407500,21317650,37707,36725150
04/05/2025,13395,29164,17345900,23761650,42559,41107550
04/06/2025,11952,20184,16286100,19388200,32136,35674300
04/07/2025,11115,15984,15392000,17337150,27099,32729150
04/08/2025,10305,13347,14151850,15484250,23652,29636100
04/09/2025,9437,11240,12837350,13835150,20677,26672500
04/10/2025,10331,10428,12669500,13151100,20759,25820600
04/11/2025,11333,12246,14161500,14557400,23579,28718900
04/12/2025,9391,11257,12240150,12942850,20648,25183000
13/04/2025,9261,9966,12023550,12381050,19227,24404600
14/04/2025,9247,9903,11856450,12452400,19150,24308850
15/04/2025,8411,9186,10961100,11149800,17597,22110900
16/04/2025,8580,8930,11667400,11858000,17510,23525400
17/04/2025,9829,8721,11874950,11647100,18550,23522050
18/04/2025,10809,10311,13047950,12588950,21120,25636900
19/04/2025,8310,10071,10810650,11695350,18381,22506000
20/04/2025,8566,9098,11253650,11048750,17664,22302400
21/04/2025,8420,8807,11232250,11631600,17227,22863850
22/04/2025,8153,8553,10879850,11318400,16706,22198250
23/04/2025,8452,8489,11089950,11240850,16941,22330800
24/04/2025,9802,8883,11729500,11927050,18685,23656550
25/04/2025,10938,9928,12695250,11895050,20866,24590300
26/04/2025,8219,10242,10349200,11976050,18461,22325250
27/04/2025,8244,8718,10626450,10691050,16962,21317500
28/04/2025,8398,8415,11348300,11433200,16813,22781500
29/04/2025,8296,8238,10855800,10863700,16534,21719500
30/04/2025,12483,9375,14166150,12430400,21858,26596550
05/01/2025,13694,10911,13643450,12880200,24605,26523650
05/02/2025,9411,11324,10595200,12125000,20735,22720200
05/03/2025,8423,12186,10646150,12382450,20609,23028600
05/04/2025,8277,9327,10770700,10854850,17604,21625550
05/05/2025,8267,8531,10782550,10803250,16798,21585800
05/06/2025,8154,8452,10584900,11159800,16606,21744700
05/07/2025,8383,8513,10754750,11032800,16896,21787550
05/08/2025,10981,9208,12106700,12138900,20189,24245600
05/09/2025,11910,10543,13130250,12605400,22453,25735650
05/10/2025,8591,9654,10660400,11086400,18245,21746800
05/11/2025,8552,10472,10835000,11978650,19024,22813650
05/12/2025,8217,9206,10752650,11108350,17423,21861000
13/05/2025,8459,8803,10856900,11461950,17262,22318850
14/05/2025,8597,8842,11095700,11749000,17439,22844700
15/05/2025,9825,8700,11727350,11526750,18525,23254100
16/05/2025,11008,10781,13054100,12861200,21789,25915300
17/05/2025,8272,9619,10595850,11203250,17891,21799100
18/05/2025,8421,9068,11283300,11570100,17489,22853400
19/05/2025,8687,8714,11630000,11825300,17401,23455300
20/05/2025,8300,8614,11200800,11509050,16914,22709850
21/05/2025,8327,8861,11181850,11861250,17188,23043100
22/05/2025,9553,8988,11880700,12194050,18541,24074750
23/05/2025,10881,10447,13605200,13156600,21328,26761800
24/05/2025,8537,9541,10986850,11566450,18078,22553300
25/05/2025,8858,9005,11910250,11810900,17863,23721150
26/05/2025,8591,8707,11636450,11838700,17298,23475150
27/05/2025,8845,9136,11938450,12494450,17981,24432900
28/05/2025,9636,9601,13092100,13336550,19237,26428650
29/05/2025,8537,8454,11784350,12283450,16991,24067800
30/05/2025,9663,9272,12724900,13034450,18935,25759350
31/05/2025,9373,9659,12608250,13052350,19032,25660600
06/01/2025,10380,10222,13892150,14553850,20602,28446000
06/02/2025,11462,10971,14767550,15892150,22433,30659700
06/03/2025,13692,11582,16481900,16552150,25274,33034050
06/04/2025,24009,13456,22414550,18491600,37465,40906150
06/05/2025,35985,16502,31643800,22684200,52487,54328000
06/06/2025,26274,13844,25841350,18952950,40118,44794300
06/07/2025,11207,7644,10002050,8176800,18851,18178850
06/08/2025,16624,11663,15011150,12668700,28287,27679850
06/09/2025,14858,14182,14009950,14251350,29040,28261300
06/10/2025,12107,16563,12232200,14795950,28670,27028150
06/11/2025,12224,18076,13407100,16475100,30300,29882200
06/12/2025,12835,18766,15165750,17908900,31601,33074650
13/06/2025,13859,24922,17428050,22474600,38781,39902650
14/06/2025,13464,25240,17948650,21989700,38704,39938350
15/06/2025,11453,16328,15642150,16884500,27781,32526650
16/06/2025,10246,12813,14221900,15021800,23059,29243700
17/06/2025,9290,10545,13021500,13251350,19835,26272850
18/06/2025,8772,9644,12162400,12705550,18416,24867950
19/06/2025,9780,9644,12310900,12448150,19424,24759050
20/06/2025,10873,11390,13635800,13694550,22263,27330350
21/06/2025,9106,10828,11923700,12418500,19934,24342200
22/06/2025,8981,9665,11705300,12035650,18646,23740950
23/06/2025,8995,9327,12066050,12287000,18322,24353050
24/06/2025,8643,8904,11683800,11851300,17547,23535100
25/06/2025,8720,9175,11467250,12049050,17895,23516300
26/06/2025,10284,9123,12217250,12060600,19407,24277850
27/06/2025,11146,10666,13458100,12712950,21812,26171050
28/06/2025,9145,10585,12334350,12605000,19730,24939350
29/06/2025,8580,8878,11141250,10944100,17458,22085350
30/06/2025,8474,8660,11127850,11154800,17134,22282650
07/01/2025,8712,8756,11433050,11672050,17468,23105100
07/02/2025,8514,8436,10989350,11134200,16950,22123550
07/03/2025,11106,9079,12188800,11958000,20185,24146800
07/04/2025,11605,10334,13404400,12874500,21939,26278900
07/05/2025,8820,9305,11107500,10923350,18125,22030850
07/06/2025,8978,10982,11445200,12205950,19960,23651150
07/07/2025,7861,8858,10449300,10571750,16719,21021050
07/08/2025,7540,7756,10303000,10578750,15296,20881750
07/09/2025,7124,7198,9810050,9974050,14322,19784100
07/10/2025,8483,7669,10470950,10403250,16152,20874200
07/11/2025,9687,9345,11813750,11371200,19032,23184950
07/12/2025,8011,9550,10159400,10998550,17561,21157950
13/07/2025,8124,8483,10529400,10892500,16607,21421900
14/07/2025,7708,7920,10419650,10689250,15628,21108900
15/07/2025,7626,7638,10293450,10230750,15264,20524200
16/07/2025,7871,8000,10299550,10577700,15871,20877250
17/07/2025,9156,8308,10794950,11024950,17464,21819900
18/07/2025,10484,9865,12315800,11783700,20349,24099500
19/07/2025,9414,10640,13171900,13553900,20054,26725800
20/07/2025,7932,8671,10056750,10545250,16603,20602000
21/07/2025,8408,8521,10945850,10872400,16929,21818250
22/07/2025,8116,8174,10585250,10695550,16290,21280800
23/07/2025,8345,8317,10619250,10814350,16662,21433600
24/07/2025,9560,8291,11109600,11077800,17851,22187400
25/07/2025,10607,9881,12382500,11950900,20488,24333400
26/07/2025,8005,9638,10077600,10927900,17643,21005500
27/07/2025,7740,8534,10167600,10420000,16274,20587600
28/07/2025,7893,7713,10509250,10378200,15606,20887450
29/07/2025,7994,7843,10591950,10292900,15837,20884850
30/07/2025,7984,8188,10212250,10975450,16172,21187700
31/07/2025,9237,8001,11148000,10859750,17238,22007750
08/01/2025,10408,9433,12517400,11877750,19841,24395150
08/02/2025,7879,10073,10010550,11622500,17952,21633050
08/03/2025,7972,8574,10516300,10798800,16546,21315100
08/04/2025,8117,8116,10352600,10584650,16233,20937250
08/05/2025,8511,8074,10604150,10290700,16585,20894850
08/06/2025,7495,8166,9428150,10065700,15661,19493850
08/07/2025,10032,8562,11464050,11258250,18594,22722300
08/08/2025,10691,10081,12715400,12244450,20772,24959850
08/09/2025,8286,10107,10598050,11227850,18393,21825900
08/10/2025,8458,9056,10967500,11045450,17514,22012950
08/11/2025,8556,8801,11165650,11440150,17357,22605800
08/12/2025,8394,8531,10930800,11044100,16925,21974900
13/08/2025,8448,8466,10916350,11329550,16914,22245900
14/08/2025,10600,8761,11791350,11394750,19361,23186100
15/08/2025,11818,10893,13075050,12919750,22711,25994800
16/08/2025,8505,10910,10393750,11744750,19415,22138500
17/08/2025,7993,9272,10421600,10767100,17265,21188700
18/08/2025,8365,8748,11119450,11197450,17113,22316900
19/08/2025,8599,8570,11332850,11369950,17169,22702800
20/08/2025,8476,8376,11185600,11147050,16852,22332650
21/08/2025,9766,8672,11519450,11398550,18438,22918000
22/08/2025,11043,10345,12851900,12483600,21388,25335500
23/08/2025,7943,9583,10233050,11065150,17526,21298200
24/08/2025,7743,8281,10146150,10065500,16024,20211650
25/08/2025,8277,8629,10922000,11208000,16906,22130000
26/08/2025,8356,8385,10867450,11116600,16741,21984050
27/08/2025,8471,8438,11065650,11124200,16909,22189850
28/08/2025,10053,8691,11732700,11512350,18744,23245050
29/08/2025,11312,10614,12925450,12687300,21926,25612750
30/08/2025,8331,10043,10503300,11331350,18374,21834650
31/08/2025,8279,8941,10723900,10901850,17220,21625750
09/01/2025,8684,8694,11375100,11189350,17378,22564450
09/02/2025,8424,8396,10949350,11142900,16820,22092250
09/03/2025,8560,8586,10782250,11310450,17146,22092700
09/04/2025,11520,9196,12367250,11807100,20716,24174350
09/05/2025,12552,10830,13544200,12829100,23382,26373300
09/06/2025,8909,12119,10813800,12917050,21028,23730850
09/07/2025,7989,10084,10272300,11203450,18073,21475750